(Language) Spanish
(Table) Extras


(Category) Subject Pronouns
i = yo
you (singular) = tú
he = él
she = ella
it (masculine) = él
it (feminine) = ella
you (formal) = usted
us = nosotros
you (plural) = vosotros 
they (masculine plural) = ellos
they (feminine plural) = ellas 


(Category) Reflexive Pronouns
myself = me
yourself = te
himself = se
herself = se
itself = se
ourselves = nos 
yourselves = vos 
themselves = se


(Category) Connectives
and = y
also = también
so (therefore) = así que
so (then) = entonces
but = pero
because = porque, ya que, puesto que, dado que
while = mientras
or = o
instead of = en vez de, en lugar de
therefore = por lo tanto, por eso
as long as = mientras que, con tal de que, en tanto que, mientras que
although = aunque, a pesar de
unless = a no ser que, a menos que
maybe = tal vez, puede ser, quizás
furthermore = además, es más, lo que es más
on the other hand = por otro lado
for example = por ejemplo
such as = como, tal como
overall = sobre todo, en general
in summary = en resumen
however = sin embargo


(Category) Prepositions
in = en
on (on top, on the surface of) = en, sobre 
at (time) = a
at (place) = en 
by (e.g. this was said by him) = por
by (close to) = por, junto a
near to = cerca de 
far from = lejos de
between = entre
behind = detrás de
in front = delante, adelante 
above (physical position) = sobre, encima de, encima
above (rank, quantity) = por encima de, por encima
below = debajo de, debajo
inside = adentro, dentro
beside = junto a, al lado de
before = antes
after = después de
during = durante
until = hasta
since = desde
throughout (place) = a través de todo, en todo
throughout (time) = durante todo, a lo largo de todo
to = a
from = de
into = en, a
through (through one end) = a través de, por
through (via) = por
along = a lo largo
across (one side to the other) = que cruza
onto = en, sobre
over = sobre, por encima de
under = bajo, debajo de


(Category) Question Words
who (singular) = quien
who (plural) = quienes
what = que
where = donde
when = cuando
how = como
why = porque
which (singular) = cual
which (plural) = cual
who (singular) (within a question) = quién
who (plural) (within a question) = quiénes
what (within a question) = qué
where (within a question) = dónde
when (within a question) = cuándo
how (within a question) = cómo
why (within a question) = por qué
which (singular) (within a question) = cuál
which (singular) (within a question) = cuáles


(Category) Common Phrases
hello = hola
goodbye = adiós
welcome (e.g. welcome to my home) = bienvenido
nice to meet you = encantado, mucho gusto, un placer
please = por favor
thank you = gracias
you’re welcome = de nada, 
yes = sí
no = no
of course = claro, por supuesto
how are you? = cómo estás, qué tal estás, qué tal, qué onda, cómo va
how much does this cost? = cuánto cuesta esto, cuánto cuesta esto
how do you say this? = cómo se dice esto, cómo se dice
what is your name? = cómo te llamas, cuál es tu nombre, cómo se llama, cuál es su nombre
my name is = me llamo


(Category) Articles (definite, indefinite, partitive)
a (masculine) = uno
a (feminine) = una
the (masculine singular) = el
the (feminine singular) = la
the (plural masculine) = los
the (plural feminine) = las
all (masculine singular) = todo
all (feminine singular) = toda
all (masculine plural) = todos
all (feminine plural) = todas
some (masculine singular) = algun
some (feminine singular) = alguna
some (masculine plural) = algunos
some (feminine plural) = algunas
few (masculine singular) = poco
few (feminine singular) = poca
few (masculine plural) = pocos
few (feminine plural) = pocas
each = cada
any (questions or negative statements) (masculine singular) = algo de
any (whichever) = cualquier
different (e.g. different foods) = diferentes, varios
too much (masculine singular) = demasiado
too many (masculine plural) = demasiados
almost all (masculine singular) = casi todo 
not any (masculine singular) = ninguno


(Category) Cardinal Numbers
one = uno
two = dos 
three = tres 
four = cuatro
five = cinco
six = seis
seven = siete 
eight = ocho 
nine = nueve
ten = diez
eleven = once
twelve = doce
thirteen = trece
fourteen = catorce 
fifteen = quince
sixteen = dieciséis
seventeen = diecisiete
eighteen = dieciocho
nineteen = diecinueve
twenty = veinte
thirty = trenta
fourty = cuarenta
fifty = cincuenta
sixty = sesenta
seventy = setenta
eighty = ochenta
ninety = noventa
hundred = cien
thousand = mil
million = millón
billion = mil millones


(Category) Ordinal Numbers
first (masculine singular) = primero
second (masculine singular) = segundo
third (masculine singular) = tercero
fourth (masculine singular) = cuarto
fifth (masculine singular) = quinto
sixth (masculine singular) = sexto
seventh (masculine singular) = séptimo, sétimo
eighth (masculine singular) = octavo
ninth (masculine singular) = noveno
tenth (masculine singular) = décimo
hundredth (masculine singular) = centésimo
thousandth (masculine singular) = milésimo


(Category) Fractional Numbers
one half = una mitad
one third = un tercio
two thirds = dos tercios
one quarter = un cuarto
one fifth = un quinto
one sixth = un sexto
one seventh = un séptimo, un sétimo 
one eighth = un octavo
one ninth = un noveno
one tenth = un décimo
one hundredth = un centésimo
one thousandth = un milésimo
