Manner
well = bene
badly = male
heavily = eccessivamente
slowly, quietly = lentamente, piano piano
only, just = appena
together = insieme
willingly = volentieri
better = meglio
worse = peggio
strongly = fortemente
simply = semplicemente
frankly = francamente
exactly = esattamente
sincerely = sinceramente
deeply, profoundly = profondamente
certainly = certamente
certainly = certamente
suddenly = improvvisamente
clearly = chiaramente
directly = direttamente
cordially = cordialmente

Time
then = dopo, poi
now = adesso
always, forever = sempre
never, never = mai
before = prima
immediately = subito
after = dopo
during = durante
again, still, yet = ancora
soon early, rapidly = presto
before, already = già
rarely = raramente
occasionally = ogni tanto
sometimes = a volte, qualche volta
often = spesso
recently = recentemente
quickly = velocemente
usually = abitualmente
finally = finalmente
quickly = velocemente

Degree
more = più
less = meno
only = solo
Much, a lot = tanto, molto
almost = quasi
little = poco
quite a lot, much = parecchio
quite, enough = abbastanza
at least = almeno
about, around = circa
at all = per nulla
especially = specialmente
particularly = particolarmente
so much, to such an extent = talmente
probably = probabilmente
possibly = possibilmente
truly, really, actually = veramente
highly = altamente
rather = piuttosto
as well, also, too = anche, pure

Place
outside = fuori
inside = dentro
above = sopra
under, below = sotto
in front = davanti
behind, back = dietro
here (precise location) = qui
here (imprecise location) = qua
there (precise location) = lì
there (imprecise location) = là
away = via
far = lontano
close = vicino
around = attorno
