big = grande
same = stesso
beautiful, gorgeous = bello
new = nuovo
sure, certain = certo
true = vero
good = buono
Italian = italiano
old = vecchio
small = piccolo
young = giovane
tall = alto
different = diverso
long = lungo
poor = povero
possible = possibile
expensive, dear = caro
full = pieno
black = nero
specific, unique = particolare
white = bianco
current = attuale
Latin = latino
impossible = impossibile
serene, sunny = sereno
pure = puro
normal = normale
perfect = perfetto
characteristic = caratteristico
Russian = russo
continuous = continuo
stupid = stupido
extreme = estremo
gray = grigio
real = reale
interesting = interessante
same = medesimo
religious = religioso
wide = ampio
blonde = biondo
official = ufficiale
attentive, alert = attento
enormous = enorme
thin = sottile
sad = triste
smallest slightest, minimal = minimo
private = privato
fast = rapido
direct = diretto
